################################################
#\....................o.......................=#
#.############################################.#
#.#####   ##     ##   ## ### #     # ### #####.#
#.#### ### ### ### ### # ### # ##### ### #####.#
#.#### ####### ### ### #  ## # ##### ### #####.#
#.#####   #### ###     # # # #    ### # ######.#
#.######## ### ### ### # ##  # ####### #######.#
#.#### ### ### ### ### # ### # ####### #######.#
#.#####   #### ### ### # ### # ####### #######.#
#.############################################.#
#.############################################.#
#.# ###   ##     #    ###     #     ## # ### #.#
#.# ## ### # ##### ### ###### # ### #  # ### #.#
#.# ## #####    ## ### ###### # ### ## # ### #.#
#.# ## ##### ##### ### ##     # ### ## #     #.#
#.# ## ##### #####    ### ##### ### ## ##### #.#
#.# ## ### # ##### ###### ##### ### ## ##### #.#
#.# ###   ## ##### ######     #     ## ##### #.#
#.############################################.#
#=....................o.......................=#
################################################