#########################
#.........\.............#
#.#.#.#.#.#o#.#.#.#.#.#.#
#.#.#.#.#.#.#.#.#.#.#.#.#
#.#.#.#.#.#.#.#.#.#.#.#.#
#.#.#.#.#.#.#.#.#.#.#.#.#
#.#.#.#.#.#.#.#.#.#.#.#.#
#.#.#.#.#.#.#.#.#.#.#.#.#
#...................=...#
#.######.###.###.######.#
#.....o#.#..==.#.#o.....#
#.######.#######.######.#
#.........o.............#
#.#######.####.########.#
#.#.....#.#..#.#......#.#
#.#.#####.#.##.######.#.#
#...............=..%....#
#########################