###########################
#.........................#
#.###########.###########.#
#.#.........\...........#.#
#.#.#########.#########.#.#
#.#.#.................#.#.#
#.#.#.#######o#######.#.#.#
#.#.#.#.............#.#.#.#
#.#.#.#.#####.#####.#.#.#.#
#.#.#.#.............#.#.#.#
#.#.#.#.#.###=###.#.#.#.#.#
#......o#.#.===.#.#o......#
#.#.#.#.#.#######.#.#.#.#.#
#.#.#.#.............#.#.#.#
#.#.#.#.#####.#####.#.#.#.#
#.#.#.#......%......#.#.#.#
#.#.#.#######.#######.#.#.#
#.#.#.................#.#.#
#.#.#########o#########.#.#
#.#.....................#.#
#.###########.###########.#
#.........................#
###########################